1111111111111111111111111111111111
1E1C1C00000C100C100C100C100C1000C1
1P10101011100C100C100C100C100C1001
101010101C111111111111111111111101
1C000C1C100C00C00C00C00C00C00C00C1
1000000000000000000000000000000011
1000000000000000000000000000000001
101C1C00000C100C100C100C100C1000C1
1010101011100C100C100C100C100C1001
101010101C111111111111111111111101
1C000C1C100C00C00C00C00C00C00C00C1
1111111111111111111111111111111111