1111111111111111111111111111111111
1P0000000000000C00000C000000000001
1010010100100000101010000000101001
1010010010101010001001000000010101
1E0000000C00C000000000000000000001
1111111111111111111111111111111111